
NO hello.xpm
WE hello1.xpm

EA hello2.xpm
SO hello3.xpm

F 1, 255, 20
C 5, 130, 0

  111111111111111111111
111111001 10S0000001011   
111000001 100000001 1000001  
100000001110000N001 1001   
     11111 11111111111111111111111  
